11111111111111111111
10000000000000000001
10000000000000000001
10000000000000000001
10000000000000000001
10000000000000000001
10000000000000000001
10000000000000000001
10000000000000000001
10000000000000000001
10000000200000000001
10000000000000000001
10000020000000000001
10000000000000000001
10002000000000200001
10000000000000000001
10000000000000000001
10000000000000000001
10400000000000020001
10000000000000000001
10002000000000000001
10000000300000000001
10200000000000000001
11111111111111111111