20000000200000000000
00111110000001111100
00100000000000000100
00100000000022000100
00100002000000000102
00102111100111100100
00120100002000100100
00100102000000100100
00002100000000100000
00000100000000100000
00000100100100100000
00000000120100000000
02000000100100000000
00000100100100100000
00000100200000100200
00000100000000100000
00100100000200100100
00100100000000100100
02100111100111100100
00100000000000000100
00100000000000000100
00100000300000000100
00111110000001111100
00000000000000000000